Map:
####################################################################################################
############.......#########################.##..################...################################
####..###..#.........#...##.........###......##...###############............##...............######
###....#...#..................##...######...####..############.##............................###...#
##..#...#..##.......##...##....#....#####....###############..####...........#.....##..............#
##..######..........##..........#....#####...##############...####...###....###...##..............##
##..#######.....................#.....####...#..###.....###....##....####...########...#.........###
##..########....#......................##...##..###....####....##...####......#####...###....#.#####
#...###....#....#......................######...###....#####...##...###.......####...###########.###
#....#.............##.......####.......######...###....####....##...###.........#....##########...##
#..........#####....#........###........####....####...###..........###..............###########...#
##..........#####.........##.####.......##......###....###...........##..............#####...#.....#
##..........#####........#########..##...#......##.....##.#.................##.......###...........#
##.......................#############...................###................#....#.................#
##....................####..#...######....................#.###.............#...###............##..#
##...###............#####......#######..#.###...............####................###................#
##...####...##......###..........##########..................####...........#...######.............#
##....##########...####...........###...#....................###.....##.....#...###.###........##..#
##....####..####...####.............#............#.......##..###.....##...########.............#####
##...#####.........#####.......##...#............#......###...###...###..########.......#......##.##
##..#######.....#...#####.....###...##.#.........##.....###....###.###....#..###.....####.........##
############...###.....##...........#####........##.....##......######.......###....####..........##
############...###.....###...........########....###.......###..#####........##.....###...........##
#####...###....####....###...........########....###......#############......##.....##...##.......##
##..............#######..........##.###..####...###.....################.....##..........##.......##
##...........##..######.........######....###...###....#########..#.####......##.........#........##
##....##.........######.........######.........####...#########...#.######....#....................#
##...###.#.......######.....##...#####........#####..#########.......########........####..........#
##..######......#######....###...####.........######..########.......#########......######.........#
##...#...##.....#######...#####..####.........#####........##........#########.......#####..##.....#
###......#......#########..####..###....#####.#####.........#........########..........###...###...#
###...####.....##########...###..........######.#...#............#...#######...........###....######
####..####...###########....##.............###.....##............####..................###.....#####
###.....#########....###....##...............##...###....##........##.......##...#.....##.......####
###......#######.......#......................##..###.....#....#...........##..........##.........##
##........#............#.....................####.###.....#....#......#...###...#......##..........#
##...###........#.#..###.............#.......###..##......##.........########.####.....####........#
###.###.........###..######..........#....##..#.####......##........#############.....#####........#
######...........###..######.........#............##................##..#######........###..##.....#
#####...................####...............#......##...................########........###......#..#
###...........##..........###......#.###...#......##.####.......####...###...#.........###.....#####
####......................####....###............#########.....#####....#....#...#....####......####
####...............#..##..###....###............####.#####.....#####........##..###...####......#.##
######....##.......##...######....#...........######....####...####.........##..###....##.......#.##
###..#########..........######.......###....########.....####..####.........######......#.......#.##
##.....#####................###....#####...###.#####.#....##...###......##..###...................##
##......####.................#.....####...###...####.#....##...###..#..#######....................##
###.....###.............###......############...####...#####....#..##..######......................#
#####..#####.###....#########..#############...#####..######....#######.#########............##....#
############################################...####..####......###################.....#....####...#
###....####################################....####..####.....##########...#######...........###...#
##.....#############################.#...#......##....####.....#####...#...######............###...#
##....###..##..####.##############.#...........#######.####...######.....................###..##...#
##...###...###.......................#........########...#....#######....................###..##..##
##...####...#.............................############........#######.....................####....##
##...#####..#.........................##..######...#..............######...................###....##
##...########....#............#####.......#####...................########.............#.......#..##
##...########..##..............####...............................###...###...................######
##....######...###.............###.............................#.####...###........###........######
##........#....................###.....#.........##....######..###.##....#...#.....########...######
##................#####.........#......##.......#####.#######..............####....########....#...#
##........###.....###..................##.......#####...####...............###############.........#
###..###.############............##...#......#########.....................##..##########..........#
#####################.............#...#.....##########.....................###..#..######......##..#
####################............##.........##########.......................#####.######.......#####
############...###..............##.........##########.....#........##........###########.......#####
##..########...###..............#####......#####..#......##........###.......##########.........####
##..######..##....................#....###.#########.................####....##.................##.#
##..######...###............##........###############.................########.....................#
##..######.....##....###...###...##...##############.........##.......########........#............#
##..#####......###.#####...##....###...#############......##.........###.####........##.............
##..#.........##########...##....###...#####..#####.................###...#....##....##.............
##...#........###..##########.....##...######..######.............####...###..####...##............#
###..#........###...#########.....#...########..####..........#..#####....##..####...####........###
######.........##....#####.#..........#########.####....#....#######..#.......####...#####.......###
######...............####.............###....##.####...##....###......##.......###...####......##.##
##.....###..........#####...##...#######.....#..####....#.....##......#............#.#.#.......#...#
##.....###..........###################......#..####..............................##...........#...#
#......####.........###.##############......##...#######.........................###..........##...#
#...##..####.........##..#########........####.......####...................###...#...........######
#.......####.........##..#########........####.......####.....###..........####...............######
#.......####..........###########...#####...##.......####......###.......##............##..##...####
#.......####............#########...######..##.......##.........#.......###......##....######...#.##
#...#######......#......####.........#####......................#.......##.............##..##..##..#
#########.#########.....####......#..######...#.................#........#.............##.....######
#######....#######......####......#..###########..##...........##.............#####....##....####..#
#####.....########.....#####..........###..#####..##..............###.....##...####.........#####.##
####......##########...#######........#.#...########..............#.......#.................########
####.......##..#####..############......#...####..#..........##............................#########
######......#.....##..############..........####...........####........................#...#########
########..............####...####............###..........####.....##.....##...#....#.....##########
#...#####..............###...##...............##.........###.......##.....############....#######..#
#.....######...........#######.......#...##....#.......####........##......#########...#...######..#
#.....######...........#######.......#..###............###.............#....#####......#...###..##.#
#......#####..........########......######..##.........#........##....###....#.#.......#...###..####
##......####...............###..##..####.....#.................###.....##..............########.####
##........#....####.........#...##..###......#.................##......##......###....##########..##
##....###......#####....................................................#..##...#.....###.#####.....
###.#####.....#####....##....................##......#..................#.####.#####...##...###.....
##########################...##################...####.....#####...#################...###########..
